1111
10C1
10E1
1C01
1CC1
1011
10P1
1111
