11111
10C11
10E11
1C011
1C011
10111
10P11
11111
