1111111111111
10010P00000C1
1000011111011
1P0011E000001
1111111111111