1111111111111111111111111111111111111111111111111111111111111111111
1000000000000000000000000000000000000000000000000000CCCC000C0000001
1E0000000000000C00000C000000000001P0000000C00C0000000000000000000C1
1010010100100000101001000000010100010010010101010001001000000010101
1010010010101010001001000000010101010010100100000101001000000010101
1P0000000C00C0000000000000000000C1E0000000000000C00000C000000000001
10000000C0000000000000E00000001111111000000111111111111111111111111
1E0000000000000C00000C000000000001P0000000C00C0000000000000000000C1
1010010100100000101001000000010100010010010101010001001000000010101
1010010010101010001001000000010101010010100100000101001000000010101
1P0000000C00C0000000000000000000C1E0000000000000C00000C000000000001
1E0000000000000C00000C000000000001P0000000C00C0000000000000000000C1
1010010100100000101001000000010100010010010101010001001000000010101
1010010010101010C01001000000010101010010100100000101001000000010101
1P0000000C00C0000000000000000010CEP0000000000000C00000C000000000001
1111111111111111111111111111111111111111111111111111111111111111111
