111111111111
1C1CC00C0CC1
10C1C0000101
1CC11100C1C1
1CCCC000C1C1
10000C1C0101
1E0P00CC0101
111111111111
