11111
1E0C1
11101
10C01
10111
101C1
1C0P1
11111
